-1 -1 -1 -1 -1 -1 -1 -1 -1 -1 -1 -1
-1 00 01 02 03 04 05 06 07 08 09 -1
-1 10 11 12 13 14 15 16 17 18 19 -1
-1 20 21 22 23 24 25 26 27 28 29 -1	
-1 30 31 32 -1 34 35 -1 37 38 39 -1 
-1 40 41 42 43 44 45 46 47 48 49 -1
-1 50 51 52 53 54 55 56 57 58 59 -1
-1 60 61 62 -1 64 65 -1 67 68 69 -1
-1 70 71 72 73 74 75 76 77 78 79 -1
-1 -1 81 82 83 84 85 86 87 88 89 -1
-2 90 91 92 93 94 95 96 97 98 99 -1
-1 -1 -1 -1 -1 -1 -1 -1 -1 -1 -1 -1